
R 800 480

S ./assets/N.png

NO ./assets/N.png
SO ./assets/S.png
EA ./assets/E.png
W ./assets/W.png

F 220,100,0
C 225,30,0

1111111
1000001
1004801
1111111
