
R 800 480

S ./assets/xpm/SP.xpm

NO ./assets/xpm/a.xpm
SO ./assets/xpm/b.xpm
EA ./assets/xpm/c.xpm
WE ./assets/xpm/W_1.xpm

F 220,100,0
C 225,30,0

1111111
1E00001
100_001
1111111
