
R 112000 1080

S ./assets/N.png

NO ./assets/N.png
SO ./assets/S.png
EA ./assets/E.png
WE ./assets/W.png

F 220,100,0
C 225,30,0

11111
11011
1S011
1S111
11111
