
R 800 480

S ./assets/xpm/SP.xpm

NO ./assets/xpm/a.xpm
SO ./assets/xpm/b.xpm
EA ./assets/xpm/c.xpm

WE ./FAKE_DIR/FAKEFILE

F 220,100,0
C 225,30,0

11111
11011
10011
10011
10011
1S111
11111
