
R 1000 1080

S ./assets/xpm/SP.xpm

NO ./assets/xpm/a.xpm
SO ./assets/xpm/b.xpm
EA ./assets/xpm/c.xpm
WE ./assets/xpm/W_1.xpm

F 220,100,0
C 225,30,0

11111
11011
00011
1S111
11111
