R 600 600 
S ./assets/xpm/SP.xpm
NO ./assets/xpm/a.xpm
SO ./assets/xpm/b.xpm
EA ./assets/xpm/c.xpm
WE ./assets/xpm/W_1.xpm
F 100,100,100 
C 100,100,100
111111111111111111111111111111111111111111111111111111
110000000000211111             000000000111111111111111111
1100000000000002111111111000000000000000100000000111111111
1111100011110000111111202000011111111000100111111111111111
1111100011110000000000000000000000000000000000000021100011
1111120000000000000000000000110001220000000000000000000W11
1110111001110000111111111101111001111211121111121111100011
111111111111111111111111111111111111111111111111111111111
