
R 1500 1020

S ./assets/large_N.png

NO ./assets/large_N.png
SO ./assets/large_S.png
EA ./assets/large_E.png
WE ./assets/large_W.png

F 75, 75, 75 
C 160, 75, 75


11111111111111111111
10000000000000000001
10000000000000000001
10000000000000000001
10000000000000000001
10001000000000000001
10000000000000000001
10000000000000000001
10000000000000000001
10000000000000000001
10000000000000000001
10000000000000000001
10000000000000000001
10000000000000000001
10000000000000000001
10000000000000000001
10000000000000001001
10000000000000000001
10000000000000000001
10000000000010000001
10000000000000000001
10000000000000000001
10000000000000000001
10000000000000000001
10000000000000000001
10000000000000000001
10000000000000000001
10000000000010000001
10000000000000000001
10000000000000000001
10N00000000000000001
10000000000000000001
11111111111111111111
