
R 1900 1400 

S ./assets/N.png

NO ./assets/N.png
SO ./assets/S.png
EA ./assets/E.png
WE ./assets/W.png

F 75, 75, 75 
C 75, 75, 75

11110
10001
10N01
10001
11111
