
R 800 500 

S ./assets/xpm/SP.xpm

NO ./assets/xpm/a.xpm
SO ./assets/xpm/b.xpm
EA ./assets/xpm/c.xpm
WE ./assets/xpm/W_1.xpm
F 75, 75, 75 
C 160, 75, 75

11111111111111
10000000000011
100000000000001111111111
111111110000N00000000010
       11000000000101111111
        1000000000101
        1000000000101          111111
        111111110010111111111100010     111         111         1       1       1     1
        11111111000000000000010     1     1       1     1       1       1       1     1
        1000000000000010111111         1111       1       1       1111
        10000000000010111     1     1       1     1       1       1       1     1
    1111111110000000000011110     11111111     1111111111111     1
    1000000000000000000000010
    1000000000000000000000010
    10000011111111111111111101
    1000001       
    10000011111111111111111111100010
    10000000000000101111111110
    1111111111111000000000010
           111111011111111111
                1010
  111           1010 
       1001011111010
        1000000010111
              00101111
                111
