
R 600 600 

S ./assets/xpm/SP.xpm

NO ./assets/xpm/a.xpm
SO ./assets/xpm/b.xpm
EA ./assets/xpm/c.xpm
WE ./assets/xpm/W_1.xpm

F 100,100,100 
C 100,100,100

1111111111111111111111111111111111111111111111111111111111
11000000E0002111111111111000000000000000111111111111111111
1100000000000002111111111011111111111100100000000011111111
1111100011110000111111002020011111111100100111111111111111
1111100011110000000000000000000000000000200000000021111111
1111120000000000000000000000000000000000000000000021111111
1110111001110000111111111101111000010010010010012211111111
1110000000110002111111111001111111111111111111111111111111
1111111111110000000000000002111111111111111111111111111111
           1000111111111111111111111111111111111111111
           12021
           11111
