
R 800 800 

S ./assets/xpm/SP.xpm

NO ./assets/xpm/N_1.xpm
SO ./assets/xpm/S_1.xpm
EA ./assets/xpm/E_1.xpm
WE ./assets/xpm/W_1.xpm

F 75, 75, 75 
C 160, 75, 75

111111111111111111
110000E00000211111
110000000000200011
111110001111000011
111110001111002011
111110000000000011
111011101111002011
111000200011000011
111111111111000111
           10001
           10001
           11111
