
R 800 600  

S ./assets/xpm/SP.xpm

NO ./assets/xpm/N_1.xpm
SO ./assets/xpm/S_1.xpm
EA ./assets/xpm/E_1.xpm
WE ./assets/xpm/W_1.xpm

F 75, 75, 75 
C 160, 75, 75


11111111111111111111
10000000000000000001
10000000000000000001
10000000000000000001
10000000000000000001
10001000000000000001
10000000000000000001
10000000000000000001
10000000000000000001
10000000000000000001
10000000000000000001
10000000000000000001
10000000000000000001
10000000000000000001
10000000000000000001
10002000000000000001
10002000000000001001
10000000000000000001
10020200000000000001
10000000000010000001
10000000000000000001
10000000000000000001
10000000000000000001
10000000000000000001
10000000000000000001
10000000000000000001
10000000000000000001
10000000000010000001
10000000000000000001
1000N000000000000001
10000000000000000001
10000000000000000001
11111111111111111111
