
R 800 500 

S ./assets/xpm/SP.xpm

NO ./assets/xpm/a.xpm
SO ./assets/xpm/b.xpm
EA ./assets/xpm/c.xpm
WE ./assets/xpm/W_1.xpm
F 75, 75, 75 
C 160, 75, 75


1111111111111111111111111111111111
11E0000000000000000000000000011111
1111111000000000000000000000011111
1111111011111111111111111111111111
1111111011110000000000000000000111
1111111000000000000000000000000111
1110011011110000000000000000000111
1110000000111111111111111111111111
1111111111111111111111111111111111
