
R 800 500 

S ./assets/xpm/SP.xpm

NO ./assets/xpm/N_1.xpm
SO ./assets/xpm/S_1.xpm
EA ./assets/xpm/E_1.xpm
WE ./assets/xpm/W_1.xpm

F 75, 75, 75 
C 160, 75, 75

111111111111111111
110000E00000211111
111111100000211111
111111101111111111
111111101111002111
111111102222000111
111001101111002111
111000200011111111
111111111111111111
