
R 600 600 

S ./assets/xpm/SP.xpm

NO ./assets/xpm/a.xpm
SO ./assets/xpm/b.xpm
EA ./assets/xpm/c.xpm
WE ./assets/xpm/W_1.xpm

F 75, 75, 75 
C 160, 75, 75

111111111111111111
110000000000211111
110000000000200011
111110001111000011
111110001111002011
111110000000N00011
111011101111002011
111000200011000011
111111111111000111
           10001
           10001
           11111
