
R 1500 1500 

S ./assets/SP_64.png

NO ./assets/brick_64/N.png
SO ./assets/brick_64/N.png
EA ./assets/brick_64/N.png
WE ./assets/brick_64/N.png

F 175, 75, 75 
C 75, 75, 75

11111111111111111111111111111111111111
10000000000000000000000000000000000001
10020000000000000000000000000000000001
10000100000000000000000000000000000001
100N0000000000000000000000000000000001
10000000000000000000000000000000000001
11111111111111111111111111111111111111
