
R 800 500 

S ./assets/xpm/SP.xpm

NO ./assets/xpm/a.xpm
SO ./assets/xpm/b.xpm
EA ./assets/xpm/c.xpm
WE ./assets/xpm/W_1.xpm
F 75, 75, 75 
C 160, 75, 75

111111111111111111111111
100000000012100000000001
100000000012100000000001
100000000012100000000001
100000000012100000000001
100000000012100000000001
100000000012100000000001
100000000012100000000001
100000000112110000000001
111111111100011111111111
12222222220E022222222221
111111111100011111111111
100000000112110000000001
100000000012100000000001
100000000012100000000001
100000000012100000000001
100000000012100000000001
100000000012100000000001
100000000012100000000001
100000000012100000000001
100000000012100000000001
100000000012100000000001
111111111111111111111111
