
R 1500 1500 

S ./assets/xpm/SP.xpm

NO ./assets/xpm/a.xpm
SO ./assets/xpm/b.xpm
EA ./assets/xpm/c.xpm
WE ./assets/xpm/W_1.xpm
F 175, 75, 75 
C 75, 75, 75

11111111111111111111111111111111111111
10000000000000000000000000000000000001
10N00000000000000000000000000000000001
10000100000000000000000000000000000001
10000000000000000000000000000000000001
10000000000000000000000000000000000001
11111111111111111111111111111111111111
