
R 800 500 

S ./assets/blank_SP.png

NO ./assets/brick_64/N.png
SO ./assets/brick_64/S.png
EA ./assets/brick_64/E.png
WE ./assets/brick_64/W.png

F 75, 75, 75 
C 160, 75, 75

111111111111111111
11E000000000011111
111111100000011111
111111101111111111
111111101111000111
111111100000000111
111001101111000111
111000000011111111
111111111111111111
